111111111111111111111111111111111111111111111111111111111111
10C100100010001000100010001000100001000100010001000100000001
101000101010101010101010101010101101010101010101010101110101
100010001000100010001000100010000100010001000100010001C1C101
101111111111111111111111110111110111111111111111111111011101
101CCC1CCCC1C10000000001C10000C101C000000000000000000001C101
101CCC1CCC1CC10111111101010111110111111111111011111111110101
101CCC1CC1CCC101000001010101C000000000000000001C000000110101
101CCCCC1CC1C10101110101010111111111111011111111111110110101
1011111CCC11C00101C101010101C0000000000000000000000C10110101
101CCCCC1CC1C10101000101010111111111111111111101111110110101
101CCC1CC1CCC101011111010101C0000000000000000000000C10110101
101CCC1CCC1CC10100000000010111101111111111111111111110110101
101CCC1CCCC1C101111111111101C00000000000C1C00000000010000101
101111111111110100010001000111111111111111111111111011110101
10100000000111000100010001000000000000000000000000101C000101
10100C00C001111111111111111111111111111111111111101011110101
1000C1CC1C01000000000000000000000000000000000000001000010101
10100C00C001011111111111111111111111111111111111111111010101
1010000000010000000000000000000000000000000C1000000000010101
101110110111111111111111111111111111111111111011111111110101
100010000100000000000000000000000000000000000010000000000101
101011111101111111111111111111111111111111111110111111101101
10101111C101C0000100000000000000000000000000000000000C10C101
101011110101111101010111111111111111111111111111111111101101
10100000010100010101000000000000000000000000000000000C100001
10111111000001C1000111111111111111111C11111111111111111111C1
101111111111111111111111111111111111111111111111111111111111
100000000000000000000000000000000000000000000000000000000PE1
111111111111111111111111111111111111111111111111111111111111
