111111111111111111111111111111111111111111111111111111111111
111111000100100000010000011000011000111110001110011001111111
111111000000000000010000011000011000111110001110011000000001
100000000000001110C001100000000000001111100000000000000000C1
100000001000001110C00110000000000100111110000000100000100111
110000000011000000000110001000000000000000000C10000000000001
1000011C0011000000000110000001111000000000000010000001000001
100000000000000010000110000100000010000010000000011000000011
1000000000000000000100000001P00000001000100001000110000C0011
110011000000000100000000C00100010C00001000010000000000000001
11001100111000000110010000000100001000000001001000010000C101
110000000000111000000000000000000C10010010000000100100010001
110000000000000010000000000100001000000000000000100000000001
100000011111000010010001110000000000000000010000000010001101
101100011111000010000000000000100000C00000C0000001001000C001
1011C000000000001000001000000000000C111000000011000000000001
1000C0000000100000000000000010001000000010010000000000000001
110001000000000000001100000000000001000000010000000000000111
100100010010010010000000000000000000000001000000000100000111
1000000000000000000000001100000100100011C0000000000000010C01
1100001000010011000000000000100000100011001C0110000000000001
110000000000001100000000000000000010000000000000100000000011
100100000000001100100001001100000000110001000000000000C00011
100000111000100000100001000000100000000000011000011111100001
100000000000000000000000000000001100000000011000000000000101
100100000001000000000100001001000000000000011000000000000101
1000C00000000000110001C0000C00010000000000011001100000000001
10001100110000001E0000011000000C000001001000000000C001111001
11100000000111100000000C000100100000000000100110010000000011
111111111111111111111111111111111111111111111111111111111111