11111111111111111111
11110000000011100011
10000010001000000011
1C000000000000001001
10100000000000000001
100000011E0000110CP1
1100000000000C000011
11000000000001000011
10010011111001001001
11111111111111111111